BW;RU;BW;ES;ES;ES;ES;ES;ES;ES;
BW;ES;BW;BW;BW;BW;ES;ES;ES;ES;
BW;ES;BW;ES;ES;BW;BW;ES;ES;ES;
BW;ES;PL;ES;RG;ES;BW;ES;ES;ES;
BW;ES;BW;BW;BW;BW;BW;ES;ES;ES;
BW;RT;BW;ES;ES;ES;ES;ES;ES;ES;
BW;BW;BW;ES;ES;ES;ES;ES;ES;ES;
ES;ES;ES;ES;ES;ES;ES;ES;ES;ES;
ES;ES;ES;ES;ES;ES;ES;ES;ES;ES;
ES;ES;ES;ES;ES;ES;ES;ES;ES;ES;