ES;ES;ES;ES;ES;ES;ES;ES;ES;ES;
ES;ES;ES;BW;BW;BW;ES;ES;ES;ES;
BW;BW;BW;BW;ES;BW;BW;RU;BW;ES;
BW;PL;ES;ES;ES;ES;ES;ES;BW;ES;
BW;BW;BW;BW;ES;BW;BW;ES;BW;ES;
ES;ES;ES;BW;ES;BW;ES;BW;ES;ES;
ES;ES;ES;BW;BT;BW;ES;ES;ES;ES;
ES;ES;ES;BW;BW;BW;ES;ES;ES;ES;
ES;ES;ES;ES;ES;ES;ES;ES;ES;ES;
ES;ES;ES;ES;ES;ES;ES;ES;ES;ES;