BW;RU;BW;ES;ES;ES;ES;ES;ES;ES;
BW;ES;BW;BW;BW;ES;ES;ES;ES;ES;
BW;ES;BW;ES;BW;BW;BW;BW;BW;BW;
BW;ES;PL;ES;RG;ES;ES;BG;ES;BW;
BW;ES;BW;BW;BW;ES;BW;ES;BW;BW;
BW;RT;BW;ES;BW;ES;BW;BW;BW;ES;
BW;BW;BW;ES;BW;BT;BW;ES;ES;ES;
ES;ES;ES;ES;BW;BW;BW;ES;ES;ES;
ES;ES;ES;ES;ES;ES;ES;ES;ES;ES;
ES;ES;ES;ES;ES;ES;ES;ES;ES;ES;