BW;RU;BW;BW;BW;BW;BW;BW;BW;ES;
BW;ES;ES;ES;ES;RG;ES;BT;BW;ES;
BW;BW;BW;BW;ES;BW;BW;BW;BW;ES;
ES;ES;ES;BW;ES;BW;ES;ES;ES;ES;
ES;ES;ES;BW;PL;BW;ES;ES;ES;ES;
ES;ES;ES;BW;BW;BW;ES;ES;ES;ES;
ES;ES;ES;ES;ES;ES;ES;ES;ES;ES;
ES;ES;ES;ES;ES;ES;ES;ES;ES;ES;
ES;ES;ES;ES;ES;ES;ES;ES;ES;ES;
ES;ES;ES;ES;ES;ES;ES;ES;ES;ES;