BW;BW;BW;BW;BW;BW;BW;BW;BW;BW;
BW;ES;ES;ES;ES;ES;ES;ES;ES;BW;
BW;ES;ES;ES;RT;ES;ES;ES;ES;BW;
BW;ES;ES;ES;ES;ES;ES;ES;ES;BW;
BW;ES;ES;ES;ES;ES;ES;ES;ES;BW;
BW;BW;BW;ES;ES;ES;ES;ES;ES;BW;
BW;ES;RG;ES;RD;ES;BT;ES;ES;BW;
BW;ES;BW;ES;ES;ES;ES;ES;ES;BW;
BW;PL;BW;ES;ES;ES;ES;ES;ES;BW;
BW;BW;BW;BW;BW;BW;BW;BW;BW;BW;