ES;ES;ES;ES;ES;ES;ES;ES;ES;ES;
ES;ES;ES;BW;BW;BW;ES;ES;ES;ES;
BW;BW;BW;BW;ES;BW;BW;BD;BW;ES;
BW;PL;ES;ES;RG;ES;ES;ES;BW;ES;
BW;BW;BW;BW;ES;BW;BW;ES;BW;ES;
ES;ES;ES;BW;ES;BW;BW;BW;BW;ES;
ES;ES;ES;BW;BT;BW;ES;ES;ES;ES;
ES;ES;ES;BW;BW;BW;ES;ES;ES;ES;
ES;ES;ES;ES;ES;ES;ES;ES;ES;ES;
ES;ES;ES;ES;ES;ES;ES;ES;ES;ES;