BW;RU;BW;ES;ES;ES;ES;ES;ES;ES;
BW;ES;BW;ES;ES;ES;ES;ES;ES;ES;
BW;ES;BW;ES;ES;ES;ES;ES;ES;ES;
BW;ES;BW;ES;ES;ES;ES;ES;ES;ES;
BW;PL;BW;ES;ES;ES;ES;ES;ES;ES;
BW;BW;BW;ES;ES;ES;ES;ES;ES;ES;
ES;ES;ES;ES;ES;ES;ES;ES;ES;ES;
ES;ES;ES;ES;ES;ES;ES;ES;ES;ES;
ES;ES;ES;ES;ES;ES;ES;ES;ES;ES;
ES;ES;ES;ES;ES;ES;ES;ES;ES;ES;