BW;RD;BW;ES;ES;ES;ES;ES;ES;ES;
BW;ES;BW;ES;ES;ES;ES;ES;ES;ES;
BW;RG;BW;ES;ES;ES;ES;ES;ES;ES;
BW;ES;BW;ES;ES;ES;ES;ES;ES;ES;
BW;PL;BW;ES;ES;ES;ES;ES;ES;ES;
BW;BW;BW;ES;ES;ES;ES;ES;ES;ES;
ES;ES;ES;ES;ES;ES;ES;ES;ES;ES;
ES;ES;ES;ES;ES;ES;ES;ES;ES;ES;
ES;ES;ES;ES;ES;ES;ES;ES;ES;ES;
ES;ES;ES;ES;ES;ES;ES;ES;ES;ES;