BW;BW;RD;BW;BW;BW;ES;ES;ES;ES;
BW;ES;ES;ES;BW;BW;ES;ES;ES;ES;
BW;PL;RG;ES;BW;BW;ES;ES;ES;ES;
BW;ES;ES;ES;BW;BW;ES;ES;ES;ES;
BW;BW;BW;BW;BW;BW;ES;ES;ES;ES;
BW;BW;BW;BW;BW;BW;ES;ES;ES;ES;
ES;ES;ES;ES;ES;ES;ES;ES;ES;ES;
ES;ES;ES;ES;ES;ES;ES;ES;ES;ES;
ES;ES;ES;ES;ES;ES;ES;ES;ES;ES;
ES;ES;ES;ES;ES;ES;ES;ES;ES;ES;