BW;RD;BW;BW;BW;BW;ES;ES;ES;ES;
BW;RG;ES;ES;BT;BW;ES;ES;ES;ES;
BW;PL;BW;BW;BW;BW;ES;ES;ES;ES;
BW;BW;BW;ES;ES;ES;ES;ES;ES;ES;
ES;ES;ES;ES;ES;ES;ES;ES;ES;ES;
ES;ES;ES;ES;ES;ES;ES;ES;ES;ES;
ES;ES;ES;ES;ES;ES;ES;ES;ES;ES;
ES;ES;ES;ES;ES;ES;ES;ES;ES;ES;
ES;ES;ES;ES;ES;ES;ES;ES;ES;ES;
ES;ES;ES;ES;ES;ES;ES;ES;ES;ES;