ES;ES;ES;BW;RU;BW;ES;ES;ES;ES;
BW;BW;BW;ES;ES;BW;ES;ES;ES;ES;
BW;PL;ES;BW;BW;BW;ES;ES;ES;ES;
BW;BW;BW;BW;ES;ES;ES;ES;ES;ES;
ES;ES;ES;ES;ES;ES;ES;ES;ES;ES;
ES;ES;ES;ES;ES;ES;ES;ES;ES;ES;
ES;ES;ES;ES;ES;ES;ES;ES;ES;ES;
ES;ES;ES;ES;ES;ES;ES;ES;ES;ES;
ES;ES;ES;ES;ES;ES;ES;ES;ES;ES;
ES;ES;ES;ES;ES;ES;ES;ES;ES;ES;