BW;RW;RD;BW;BW;BW;
BW;ES;ES;ES;BW;BW;
BW;PL;RG;ES;BW;BW;
BW;ES;ES;ES;RW;BW;
BW;BW;BW;BW;BW;BW;
BW;BW;BW;BW;BW;BW;